fullname : My full name is Austin Richard Post!
born : I was born in Syracuse, New York and moved to Grapevine, Texas when I was nine years old!
single : My first single was White Iverson.
first : Stoney was my first album and was released in 2016.
second : Beerbongs & Bentleys was my second album, and that was released in 2018.
grammy : I was nominated for a grammy in 2018 for Rockstar and Psycho.
festival : I have my own festival called Posty Fest that's held at the Dos Equis Pavillion!
latest : Hollywood's Bleeding is my most recent album I've released!
beer : My favourite beer is Bud Light, they sold their beer with my face on it!
records : In total, I've sold over 65 million records in the US.
diamond : I have one song that has received diamond certification, which is Congratulations.
birthdate : My birthday is July 4, 1995.
guitar : I first got into guitar when I played guitar hero, and decided to try learning a real one. It's paid off a bit.
name : when I was 15 I got my rap name from an online rap name generator, when I put in my name it generator Post Malone.
college : I went to college but dropped out after a semester because it wasn't for me.
la : I moved to LA when I dropped out of college and lived on my buddies couch who was a professional online game streamer.
label : I signed my first record deal with Republic Records in August 2015 after releasing White Iverson.
tattoos : I have too many tattoos, I've lost count.
favourite : My favourite song I've released is Psycho.
grammies : I've received a total of 6 grammy nominations.
shoes : My favourite shoe brand is crocs.
tour : I'm currently on the second-leg of my 'On The Run' tour!
influence : One of my biggest influences is Bob Dylan.
highschool : I was voted 'most likely to be famous' in my highschool.
work : I worked at Chicken Express for 2 years before pursuing music.
drink : My favourite drink is Beer.
football : My favourite football player is Dak Prescott. Go Cowboys!
travel : My favourite place to travel to is definitely Austrailia!
games : I play video games, I really like call of duty and PUBG!
postmates : I spent $40,000 on postmates last year. I like food.
band : I tried to join a band once, but I got rejected when my guitar strings broke during my audition.
zodiac : My zodiac sign is a Cancer!
fasion : I love fashion. I love Saint Laurent and keeping up with new fashion trends.
hockey : My favourite hockey team is the Dallas Stars!
height : I am 6 feet tall. Not too tall not too short!
job : I started out as a wedding DJ but I really wanted to be a metal guitarist. 
fear : my biggest fear is definitely flying. One time in 2018, on my way to London, 2 of the planes tires burst during takeoff and my anxiety was through the roof! We made it out ok though.
hobbies : I don't really have regular hobbies but I do have a loafer collection. When I was working at Chicken Express, I once saved up enough to buy an $800 pair of Versace loafers!
artists : My favorite artists are Bob Dylan, Green Day, and Kendrick Lamar.
perform : I had a blast preforming with G eazy and YG!
eazy : He is such a humble and easy going guy, we get alone really well.
collaborate: Working with Justin Bieber to make the song Deja Vu, was a great experience.
Beieber : Justin has been in the game for a long time and see things differently.
21 : The dude is dark, his music shows it and that's what makes him a savage.
Wrld : That kid was a true blessing to the music world, I wish I had a chance to perform with him.
Migos : I love the Migos they are so original, they can almost make any genre of music.
Swae : Heâ€™s my boy! we made Sunflower and many more songs, go check them out on Spotify!
Ty : Ty Dolla Sign is a chill dude and his music is vibin.
Green : I have loved Green Day since I was a kid. I always was into punk rock.
Bob : Bob Dylan was one of the first artist that actually spoke to me, he was smooth.
Kendrick : Man, Kendrick is a goat. enough said.
Hasley : She is a talent women that makes hella good music.
Future : Future is an OG, there is a good chance we will make something together soon!
Lil : Lil Baby's killin it right now, hes young and has the flow.
Dababy : Man, Dababy is a gangsta straight up his music goes hard.
Jackson : Michael Jackson was the greatest, he changed so much in the music world, he inspired me to make the music I wanted to.
